NDEHSDVLPVLDVCSLKHVAYVFQ	NDKDDESLPAETGQNHPFFR
KAMNQQTTLDTPQLE	KCLVEVTMDRNCLE
SLMRSHNDEHSDVLPVLDVCSLK	SMLAEEADSSKPGPSAHDVAAQLK
MMSARGDFLNYALSLMRSHND	LTSFRPQCSFMGMVISHD
KAMNQQTTLDTPQLE	KLRNQQSRDLSLE
SDVLPVLDVC	NEKLPNLDC
RGDFLNYALSLMRSHNDEHSDVLPVLDVCSLKHVAYVFQALIYWIKAMNQ	RDFRRQLSIDTRPFRPASEGNPSDDPDPLPAHRQALGERLYPRVQAMQ
SARGDFLNYALSLMRSHNDEHSDVLPVLDVCSLK	SLRARVEEAMELIVAHGRENGADSILDLGLLDSSEK
VLDVCSLKH	ILGLCLLQN
DFLNYALSLMRSHNDEHSDVLPVLDV	DPVMYESLRQLILASQSSDADAVFSAMDL
MRSHNDEHSDVLPVLDVCSLKHVAYVFQALIYWIKAMNQQTTLD	VRKYAEHRMLVVAEQPLHAMRKGLLDVLPKNSLEDLTAED
GDFLNYALSLMRSHNDEHSD	GEVNVQMLISFTSFNDESGE
SLMRSHNDEHSDVLPVLDVCSLKHVAYVFQALIYWIKAMNQQTTL	SITIRPPDDQHLPTANTCISRLYVPLYSSKQILKQKLL
SDVLPVLDVCSLKHVAYVFQALIYWIKAMNQQ	SGVDPITFDINSNQTGPAFLTAVEMAGVKYLQVQ
YALSLMRSHNDEHSDVLPVLDVCSLKHVAYVFQALIYWIKAMNQ	YTGAIVTNNDGPYMAYVEVLGDPNLQFFIKSGDAWVTLSE
HSDVLPVLDVCSLKHVAYVFQALIYWIKAMNQQTTLDT	HEYLAKLQEIRQAVHIESVFSLNMAFQLENNKYEVET
MRSHNDEHSDVLPV	MMSNRYFQHVDDKYVPI
ESLPAETGQNHPFFRRSDSMTFLG	EAIPLADQPHLLQPNARKEDLFG
LELGIDNEDSEHENDDDTSQSATLNDKDDESLPAETGQN	LKNVMNMQNRQKKAGEDQSMLAEEADSSKPGPSAHD
RTRELLELGIDNED	RWRLSLELFGRVFMED
SQSATLNDKDDESLPAETGQNHPFFRR	SRDLSLEVDRDRDLLIQQTMRQLNNHFGRR
KRTRELLELGIDNEDSEHENDDDTSQSATL	KGTHTSLMQRLRNRGERDREREREREMRRSSGL
DNEDSEHENDDDTSQSATLNDKDDESLPAETGQNHP	DRDRDFRRQLSIDTRPFRPASEGNPSDDPDPLPAHRQALGERLYP
RKRTRELLELGIDNEDSEHEN	RENGADSILDLGLLDSSEKVQEN
LNDKDDESLPAETGQNHPFFRRSDSMTFLGC	LDDTDDGDDNAPLFYQPGKRGFYTPRPGKNTEARLNC
RELLELGIDNEDSE	RQLILASQSSDAD
SLPAETGQNHPFFRR	NIPVTPQNVYEYVRK
SATLNDKDDESLPAE	SFTSFNDESGENAE
SATLNDKDDESLPAET	SITIRPPDDQHLPTANT
DDESLPAETGQNHPFFRRSDSMT	DNHGVGPQGASGVDPITFDINSNQT
TSQSATLNDKDDESLPAETGQNHPFFRRSDSMT	TGAIVTNNDGPYMAYVEVLGDPNLQFFIKSGDAWVT
ELLELGIDNEDSEHENDDDTSQSATLNDKDDESLPAETGQNHPFFRRS	EYLAKLQEIRQAVHIESVFSLNMAFQLENNKYEVETHAKNGANMVTFIPRN
DDDTSQSATLNDKDDESLPAETGQNH	DDNGMMSNRYFQHVDDKYVPISQKNY
LQPNARKEDLFGRPSQGLYSSSAGSGK	MQNRQKKAGEDQSMLAEEADSSK
HLLQPNARKEDLFGRPSQGLYSSSAGSGKCLVEV	HDMLLGRWRLSLELFGRVFMEDVGAEPGSILTEL
DQPHLLQPNARKEDLFGR	DRDLLIQQTMRQLNNHFGR
FEVPLAEAIPLADQPHLLQPNARK	FYTAIAQAFLSNEKLPNLDCIQNANK
PFEVPLAEAIPLADQPHLLQPNARKEDLFGRPSQGLYSSSAGSGK	PFRPASEGNPSDDPDPLPAHRQALGERLYPRVQAMQPAFASK
PSQGLYSSSAGSGKCLVEVTMD	PAQLLLLLASEDSLRARVEEAME
LFGRPSQGLYSSSAGSGKCLVEVTMDRNC	LFYQPGKRGFYTPRPGKNTEARLNC
FEVPLAEAIPLADQ	YESLRQLILASQ
EVPLAEAIPLADQPHLLQPNARKEDLFGRPSQGLYSSSAGSGKCLVEVTMDRNCLEVLPT	ELIPNGVNIPVTPQNVYEYVRKYAEHRMLVVAEQPLHAMRKGLLDVLPKNSLEDLT
LVEVTMDRNCL	IVERMSMTERQDL
FEVPLAEAIPLADQPHLLQPNARKEDLFGRPSQGLYSSSAGSGKCLVEVTMDRN	FQPMPSITIRPPDDQHLPTANTCISRLYVPLYSSKQILKQKLLLAIKTKN
FEVPLAEAIPLADQPHLLQPNARKEDLFGRPSQGLYSSSAGSGKCLVEV	FNILCLFPVLAADNHGVGPQGASGVDPITFDINSNQTGPAFLTAVEMAGVKYLQV
HLLQPNARKEDLFGRPSQGLYSSSAGSGKCLVEVTMDRNCLE	HRLVEGNVVIWENASTPLYTGAIVTNNDGPYMAYVEVLGDPNLQ
NPFEV	NKYEV
LVEVTMDRN	LINVFSIDDN
DVAAQLKSSLLAEIG	DVGAEPGSILTELG
KNVMNMQNRQKKAGEDQSMLAEE	KLRNQQSRDLSLEVDRDRDLLIQQ
ANLKNVMNMQNRQKKAGEDQSMLAEEADSSKPG	ANKGTHTSLMQRLRNRGERDREREREREMRRSSG
AEEADSSKPGPSAH	ASEGNPSDDPDPLPAH
AGEDQSMLAEEADSSKPGPSAHDVAAQLKSSLLAEIGLTESE	ASEDSLRARVEEAMELIVAHGRENGADSILDLGLLDSSE
VMNMQNRQKKAGEDQSMLAEEADSSKPGPSAHDVAAQLKSSLLAEIGL	VVDMDLDDTDDGDDNAPLFYQPGKRGFYTPRPGKNTEARLNCFRNIGRILGL
QSMLAEEADSSKPGPSAHDVAAQLK	QLILASQSSDADAVFSAMDLAFAVDLCK
NVMNMQNRQKKAGEDQSMLAEEADSSKPGPSAHDVAAQLKSSLLAEIGLTESE	NIPVTPQNVYEYVRKYAEHRMLVVAEQPLHAMRKGLLDVLPKNSLEDLTAE
GEDQSMLAEEADSSKPGPSAHDVAAQLKSSLLAEIGLTESE	GEVNVQMLISFTSFNDESGENAEKLLQFKRWFWSIVERMSMTERQ
EDQSMLAEEADSSKPGPSAHDVAAQLKSSLLAEIGLTESEG	DDQHLPTANTCISRLYVPLYSSKQILKQKLLLAIKTKNFG
QKKAGEDQSMLAEEADSSKPGPSAHDVAAQL	QGASGVDPITFDINSNQTGPAFLTAVEM
MSYAANLKNVMNMQNRQKKAGEDQSMLAE	MAYVEVLGDPNLQFFIKSGDAWVTLSE
HDVAAQLKSSLLAEIGLTES	HEYLAKLQEIRQAVHIES
NVMNMQNRQKKAGEDQSMLAEE	NGMMSNRYFQHVDDKYVPISQK
DMLLGRWRLSLELFGR	DLLIQQTMRQLNNHFGR
GAEPGSILTELGGFEVKESKFRREM	GTHTSLMQRLRNRGERDREREREREM
FRPQCSFMGMVISHDMLLGRWRLSLELFGRVFMEDVGAEPGSIL	FRPASEGNPSDDPDPLPAHRQALGERLYPRVQAMQPAFASKITGMLL
PQCSFMGMVISHDMLLGRWRLSLELFGRVFMEDVGAEPGSILTELGGFEVKESKFRRE	PAQLLLLLASEDSLRARVEEAMELIVAHGRENGADSILDLGLLDSSEKVQE
TSFRPQCSFMGMVI	TEARLNCFRNIGRIL
MLLGRWRLSLELFGRVFMEDV	VLLGRKVNWHDFAFFDPVMYESL
MGMVISHDMLLGRWRLSLELFGRVFMEDVGAEPGSIL	MLVVAEQPLHAMRKGLLDVLPKNSLEDLTAEDFRLL
TSFRPQCSFMGMVISHDMLLGRWRLSLELFGRVFMEDV	TSFNDESGENAEKLLQFKRWFWSIVERMSMTERQDL
EDVGAEPGSILT	EEGFQPMPSIT
DVGAEPGSILTELGGFEVK	DINSNQTGPAFLTAVEMAGVK
GMVISHDMLLGRWRLSLELFGRVFMEDVGAEPGSILTELG	GSNVNIHRLVEGNVVIWENASTPLYTGAIVTNNDGPYMAYVEVLG
SILTELGGFEVKESKFRRE	SVFSLNMAFQLENNKYEVE
LLGRWRLSLELFGRVFMEDVG	VVGFFRGLRLLLINVFSIDDNG
EKLRNQQSRDLSLEVDRDRDL	QRLRNRGERDREREREREM
DRDRDLLIQQTMRQLNNHFGRRCATTPMAVHR	DRDRDFRRQLSIDTRPFRPASEGNPSDDPDPLPAHR
LSLEVDRDRDLLIQQTMRQLNNHFGR	LASEDSLRARVEEAMELIVAHGR
DLSLEVDRDRD	DMDLDDTDD
DLLIQQTMRQL	DPVMYESLRQL
AVHRVKVTFKDEP	AEHRMLVVAEQP
CATTPMAVHRVKVTFKDEPGEGS	CGEVNVQMLISFTSFNDESGENA
SRDLSLEVDRDRDLLIQQTMRQLNNHFG	SRLYVPLYSSKQILKQKLLLAIKTKNFG
PGEGSGV	PQGASGV
ATTPMAVHRVKVTFKDEP	ASTPLYTGAIVTNNDGP
EKLRNQQSRDLSLEVDRDRDLLIQQTMRQLNNHFGRRCATTPMAVHRVKVTFKD	EYLAKLQEIRQAVHIESVFSLNMAFQLENNKYEVETHAKNGANMVTFIPRNGHICKMVYHKN
VDRDRDLLIQQ	VDDKYVPISQ
REREREMRR	RDRDRDFRR
NKGTHTSLMQRLRNRGERDREREREREMRRS	NGADSILDLGLLDSSEKVQENRKRHGSSRS
FYTAIAQAFLSNEKLPNLDCIQNANKGTHTSLMQ	FYTPRPGKNTEARLNCFRNIGRILGLCLLQ
YTAIAQAFLSNEKLPNLDCIQNA	YESLRQLILASQSSDADAVFSA
EKLPNLDCIQNANKGTHTSLMQRLRNRGERDREREREREMRRSSGL	ELIPNGVNIPVTPQNVYEYVRKYAEHRMLVVAEQPLHAMRKGL
AFLSNEKLPNLDCIQNANKGTHTSLMQRLRNRGERD	SFTSFNDESGENAEKLLQFKRWFWSIVERMSMTERQD
NEKLPNLDCIQNANKGTHTSLMQRLRNR	DQHLPTANTCISRLYVPLYSSKQILKQK
PNLDCIQNANKGTHTSLMQRLRNRG	PITFDINSNQTGPAFLTAVEMAG
NLDCIQNANKGTHTSLMQRLRNRG	NVVIWENASTPLYTGAIVTNNDG
SFYTAIAQAFLSNEKLPNLDCIQNANKGT	SVFSLNMAFQLENNKYEVETHAKNGANMVT
LSNEKLPNLDCIQNANKGTHTSLMQRL	MSNRYFQHVDDKYVPISQKNYETGIVKL
PAHRQALGERLYPRVQAMQ	PAQLLLLLASEDSLRARVEEAME
SDDPDPLPAHRQALGERLYPR	TDDGDDNAPLFYQPGKRGFYTPR
AMQPAFA	AMDLAFA
GNPSDDPDPLPAHRQALGERLYPRVQAMQPAFASKITGML	GVNIPVTPQNVYEYVRKYAEHRMLVVAEQPLHAMRKGLL
SDDPDPLPA	TSSPSLPA
RPFRPASEGNPSDDPDPLPAHRQALGERLYPRVQAMQPAFASKI	QPMPSITIRPPDDQHLPTANTCISRLYVPLYSSKQILKQKL
LSIDTRPFRPASEGNPSDDPDPLPAHRQALGERLYPRVQ	LAADNHGVGPQGASGVDPITFDINSNQTGPAFLTAVEMAGVKYLQVQ
TRPFRPASEGNPSDDPDPLPAHRQALGERLYPRVQ	TPLYTGAIVTNNDGPYMAYVEVLGDPNLQ
RQALGERLYPRVQAMQ	RQAVHIESVFSLNMAFQ
DRDFRRQLSIDTRPFRPASEGN	NRYFQHVDDKYVPISQKN
ILDLGLLDSSEKVQEN	VVDMDLDDTDDGDDN
LLLASEDSLRARVEEAMELIVAHGRENG	LILASQSSDADAVFSAMDLAFAVDLCKEEG
LRARVEEAMELIVAHGRENGADSILDLGLLDSSE	VRKYAEHRMLVVAEQPLHAMRKGLLDVLPKNSLEDLTAE
ELSPAQLLLLLASEDSLRARVEEAME	EVNVQMLISFTSFNDESGENAEKLLQ
AQLLLLLASEDSLRARV	SRLYVPLYSSKQILKQKL
HGRENGADSILDLGLLDSSE	HGVGPQGASGVDPITFDINSNQ
ENGADSILDLGLLDSSE	ENASTPLYTGAIVTNND
ARVEEAMELIVAHGRENGADSILDLGLLDSSEKVQENRKRHGSS	AKLQEIRQAVHIESVFSLNMAFQLENNKYEVETHAKNGAN
QLLLLLASEDSLRARVEEAMELIVAHGRENGADSILDL	RLLLINVFSIDDNGMMSNRYFQHVDDKYVPISQKNYETGIVKL
PLFYQPGKRGFYTPRPGKNTEARLNCFRNIGRILGLC	PVMYESLRQLILASQSSDADAVFSAMDLAFAVDLC
EARLNCFRNIGRILGLCLLQNELCPIT	EQPLHAMRKGLLDVLPKNSLEDLT
DDGDDNAPLFYQPGKRGFYT	DESGENAEKLLQFKRWFWS
KRGFYTPRP	EEGFQPMP
LCLLQNELCPI	LILLFNILCLFPV
NIGRILGLCLLQNELCPIT	NIHRLVEGNVVIWENASTPLYT
KNTEARLNCFRNIGRILGLCLLQN	KNGANMVTFIPRNGHICKMVYHKN
RGFYTPRPGKNTEARLNCFRNIGRIL	RIYKATGNDTVTSVVGFFRGLRLL
FDPVMYESLRQLILASQSSDADAVFSAMDLAFAVDLCKEE	YEYVRKYAEHRMLVVAEQPLHAMRKGLLDVLPKNSLEDLTAED
KVLLGRKVNWHDFAFFDPVMYESLRQLILASQSS	KLLQFKRWFWSIVERMSMTERQDLVYFWTSS
PVMYESLRQLILASQSSD	PLYSSKQILKQKLLLAIKTKN
VFSAMDLAFAVDLCKEEGGGQ	LFNILCLFPVLAADNHGVGPQ
NRHVIKVLLGRKVNWHDFAFFDPVMY	NVNIHRLVEGNVVIWENASTPLY
YESLRQLILASQSSDADAVFSAMDLAFAVDLCKEE	HEYLAKLQEIRQAVHIESVFSLNMAFQLENNKYE
KVNWHDFAFFDPVMYESLRQLILASQSSDADAVFS	KATGNDTVTSVVGFFRGLRLLLINVFSIDDNGMMS
AEQPLHAMRKGLLDVLPKNSLEDL	AEKLLQFKRWFWSIVERMSMTERQDL
PNGVNIPVTPQNVYEYVRKYAEHRMLVVAEQPLHAMRK	PDDQHLPTANTCISRLYVPLYSSKQILKQKLLLAIKTK
PNGVNIPVT	PQGASGVDPIT
GVNIPVTPQNVYEYVRKYAE	GAIVTNNDGPYMAYVE
VELIPNGVNIPVTPQNVYEYVRKYAEHR	VETHAKNGANMVTFIPRNGHICKMVYHK
IPVTPQNVYE	VPISQKNYE
EKLL	QKLL
NGCGEVNVQMLISFTSFNDESG	NHGVGPQGASGVDPITFDINSNQTG
VERMSMTERQDLVYFWTSSPSLP	IHRLVEGNVVIWENASTP
VNVQMLISFTSFNDESGENAE	VHIESVFSLNMAFQLENNKYEVE
MLISFTSFNDESGENAEKLLQ	LLINVFSIDDNGMMSNRYFQ
DQHLPTANTCISRLYVPLYSSKQILKQKLLLAIK	DNHGVGPQGASGVDPITFDINSNQTGPAFLTAVE
HLPTANTCISRLYVPLYS	HRLVEGNVVIWENASTPLYT
YSSKQILKQKLLLAIKTKNFGF	YLAKLQEIRQAVHIESVFSLNMAF
YVPLYSSK	YVPISQK
QGASGVDPITFDINSNQTGPAFLTAVEMAGVKYLQ	ENASTPLYTGAIVTNNDGPYMAYVEVLGDPNLQ
LFNILCLFPVLAADNHGVGPQGASGVDPITFDINSN	VFSLNMAFQLENNKYEVETHAKNGANMVTFIPRN
LCLFPVLAADNHGVGPQGASGVDPITFDINSNQTG	LLLINVFSIDDNGMMSNRYFQHVDDKYVPISQKNYETG
NVNIHRLVEGNVVIWENASTPLYTGAIVT	SLNMAFQLENNKYEVETHAKNGANMVT
NLQFFIKSGDAWVTLSE	NRYFQHVDDKYVPISQ
VFSLNMAFQLENNKYEVETHAKN	MMSNRYFQHVDDKYVPISQKN
